"filename", "language", "C#", "JSON", "UnityShader", "comment", "blank", "total"
"c:\Users\tw21re\Documents\GitHub\BTGD9856_Game\Assets\Scripts\Bullets\Bullet.cs", "C#", 47, 0, 0, 6, 9, 62
"c:\Users\tw21re\Documents\GitHub\BTGD9856_Game\Assets\Scripts\Bullets\ExpandingBullet.cs", "C#", 77, 0, 0, 11, 23, 111
"c:\Users\tw21re\Documents\GitHub\BTGD9856_Game\Assets\Scripts\CameraDolly.cs", "C#", 13, 0, 0, 0, 6, 19
"c:\Users\tw21re\Documents\GitHub\BTGD9856_Game\Assets\Scripts\FogHider.cs", "C#", 54, 0, 0, 6, 13, 73
"c:\Users\tw21re\Documents\GitHub\BTGD9856_Game\Assets\Scripts\Interactables\IInteractable.cs", "C#", 12, 0, 0, 19, 9, 40
"c:\Users\tw21re\Documents\GitHub\BTGD9856_Game\Assets\Scripts\Interactables\Implementations\Barricade.cs", "C#", 140, 0, 0, 32, 40, 212
"c:\Users\tw21re\Documents\GitHub\BTGD9856_Game\Assets\Scripts\Interactables\InteractableManager.cs", "C#", 74, 0, 0, 1, 15, 90
"c:\Users\tw21re\Documents\GitHub\BTGD9856_Game\Assets\Scripts\LockRotation.cs", "C#", 18, 0, 0, 0, 4, 22
"c:\Users\tw21re\Documents\GitHub\BTGD9856_Game\Assets\Scripts\Player\PlayerBody.cs", "C#", 47, 0, 0, 17, 22, 86
"c:\Users\tw21re\Documents\GitHub\BTGD9856_Game\Assets\Scripts\Player\PlayerController.cs", "C#", 46, 0, 0, 13, 20, 79
"c:\Users\tw21re\Documents\GitHub\BTGD9856_Game\Assets\Shaders\FogShader.shader", "UnityShader", 0, 0, 32, 8, 8, 48
"c:\Users\tw21re\Documents\GitHub\BTGD9856_Game\GlobalSuppressions.cs", "C#", 2, 0, 0, 5, 3, 10
"c:\Users\tw21re\Documents\GitHub\BTGD9856_Game\Packages\manifest.json", "JSON", 0, 47, 0, 0, 1, 48
"c:\Users\tw21re\Documents\GitHub\BTGD9856_Game\Packages\packages-lock.json", "JSON", 0, 381, 0, 0, 1, 382
"Total", "-", 530, 428, 32, 118, 174, 1282